11111111111111111111111111111111111111111111111111111111111111
10000000000001000000000000000000000000000000100000000000000001
10000000000001000000000000000000000000000000100000000000000001
10000000000001000000000000000000000000000000100000000000000001
10000000000001000000000000000000000000000000100000000000000001
10000000000001000000000000000000000000000000100000000000000001
10000000000001000000000000110000000000000000100000000000000001
10000000000001000000000000110000000000000000100000000000000001
10000000000001000000000000010000000000000000100000000000000001
10000000000001111111111111110000000000000000100000000000000001
10000000000000000000000000000000000000000000100000000000000001
10000000000000000000000000000000000000000000100000000000000001
10000000000000000000000000000000000000000000100000000000000001
10000000000000000000000000000000000000000000100000000000000001
10000000000000000011000000000000000011111111100000000000000001
10000000000000000011000000000000000011000000000000000000000001
10000000000000000001000000000000000000000000000000000000000001
10000000000000000001111100000000000000000000000000001100000001
10000000000000000000000100000000000000000000000000001100000001
10000000000000000000000100000000000000000000000000000100000001
10000000000000000000000100000000000000000000000000000100000001
10000000000000000000000100000000000000000000000000000100000001
10000000000000000000000110000000000000000000000000000100000001
10000000000000000000000110000000000000000000000000000100000001
10000000000000000000000000000000000000000000000000000100000001
10000000000000000000000000000000000000000000000000000100000001
10000000000000000000000000000000000000000000000000000100000001
10000000000000000000000000000000000000000000000000000100000001
10000000000000000000000000000000000000000000000000000100000001
10000000000000000000000000000000000000000000000001111100000001
10000000000000000000000000000000000000000000000001000000000001
10000000000000000000000000000000000000000000000001000000000001
10000000000000000000000000000000000000000000000001000000000001
10000000000000000001111100000000000000000000000001000000000001
10000000000000000001100100000000000000000000000001000000000001
10000000000000000000000100000000000000000000000001000000000001
10000000000000000000000100000000000000000000000001000000000001
10000000000000000000000100000000000000000000000001000000000001
10000000000000000000000100000000000000000000000001000000000001
10000000000000000000000100000000000000000000000001000000000001
10000000000000000000000100000000000000000000000001000000000001
11111111111111111111111111111111111111111111111111111111111111
00000100010000000000000000000000000000000000000000000000000000